13333333333333333331
10000005000000000001
10000022220000000001
10000000000000050001
10000000500022222221
10000002222000000001
10000500000000000001
10022220000000000001
10005000000000000001
12222222222220000041
10000000000000002221
10000000060000000001
12222222222222222221
11111111111111111111
